1111111111111111111111
10000C0001010000010001
1111100E01010000000001
10000000010100P0000001
1000000000000000C00001
1000010000111111001001
10000100000000000100E1
1111111111111111111111